{
"tiles" : [ [1, 1, 1, 0, 1, 1, 1],
            [1, 1, 0, 1, 1, 1, 1],
            [1, 1, 1, 1, 1, 1, 1],
            [1, 0, 1, 1, 1, 1, 1],
            [0, 1, 1, 1, 1, 1, 1],
            [0, 1, 1, 1, 1, 1, 1],
            [0, 1, 1, 1, 1, 1, 1],

    ],

  "targetScore" : 500,
  "moves" : 50,
  "names" : "Luxury Level"
}
